%%%%%%%%%
%   P   %
%.%% %%.%
%.%.   .%
%%%%%%%%%