%%%%%
%% %%
%% %%
%%P%%
%% %%
%%%%%
