%%%%%
%% %%
% P %
%% %%
%%%%%
