%%%%%
%% %%
% P %
%   %
%%%%%
